date,bkcasecount,bkhospitalizedcount,bkdeathcount,new_confirmed,new_hospitalized,new_deceased,mncasecount,mnhospitalizedcount,mndeathcount,qncasecount,qnhospitalizedcount,qndeathcount,sicasecount,sihospitalizedcount,sideathcount,bxcasecount,bxhospitalizedcount,bxdeathcount,key,total_confirmed,total_hospitalized,total_deceased
2020-02-29,0,4,0,0,3,0,1,2,0,0,2,0,0,0,0,,,,US_NY_36005,0,3,0
2020-03-01,0,0,0,1,1,0,0,0,0,0,2,0,0,1,0,,,,US_NY_36005,1,4,0
2020-03-02,0,4,0,0,9,0,0,4,0,0,5,0,0,0,0,,,,US_NY_36005,1,13,0
2020-03-03,0,5,0,1,7,0,0,2,0,1,5,0,0,1,0,,,,US_NY_36005,2,20,0
2020-03-04,1,5,0,0,6,0,2,6,0,2,3,0,0,2,0,,,,US_NY_36005,2,26,0
2020-03-05,3,5,0,0,2,0,0,6,0,0,6,0,0,1,0,,,,US_NY_36005,2,28,0
2020-03-06,1,3,0,2,5,0,3,3,0,1,5,0,1,2,0,,,,US_NY_36005,4,33,0
2020-03-07,2,6,0,0,2,0,1,4,0,3,3,0,1,0,0,,,,US_NY_36005,4,35,0
2020-03-08,5,9,0,4,2,0,6,1,0,5,5,0,1,0,0,,,,US_NY_36005,8,37,0
2020-03-09,16,15,0,4,11,0,25,12,0,10,8,0,3,3,0,,,,US_NY_36005,12,48,0
2020-03-10,11,13,0,8,8,0,24,13,0,24,23,0,2,5,0,,,,US_NY_36005,20,56,0
2020-03-11,31,15,0,19,20,0,61,21,0,40,30,1,3,3,0,,,,US_NY_36005,39,76,0
2020-03-12,96,26,0,29,16,0,137,11,0,80,29,0,13,5,0,,,,US_NY_36005,68,92,0
2020-03-13,166,36,0,79,34,0,182,27,0,166,48,0,26,3,0,,,,US_NY_36005,147,126,0
2020-03-14,163,36,1,86,26,0,179,28,0,194,57,1,22,8,0,,,,US_NY_36005,233,152,0
2020-03-15,430,43,0,118,34,1,209,30,2,230,64,1,46,16,1,,,,US_NY_36005,351,186,1
2020-03-16,739,83,1,303,65,3,458,40,0,530,106,4,91,17,0,,,,US_NY_36005,654,251,4
2020-03-17,786,98,4,343,65,1,566,57,0,650,108,3,108,21,0,,,,US_NY_36005,997,316,5
2020-03-18,970,111,6,483,100,1,540,76,4,832,152,9,150,23,0,,,,US_NY_36005,1480,416,6
2020-03-19,1209,147,6,620,122,4,554,91,4,1065,160,6,258,32,4,,,,US_NY_36005,2100,538,10
2020-03-20,1140,186,10,719,111,13,657,110,11,1184,223,9,309,30,3,,,,US_NY_36005,2819,649,23
2020-03-21,558,172,12,483,152,12,402,115,5,945,223,14,248,34,1,,,,US_NY_36005,3302,801,35
2020-03-22,757,182,10,491,163,12,322,126,8,695,223,14,316,32,6,,,,US_NY_36005,3793,964,47
2020-03-23,911,276,27,723,207,12,538,174,7,1189,332,28,209,46,8,,,,US_NY_36005,4516,1171,59
2020-03-24,1211,300,23,927,253,14,628,188,17,1389,361,34,349,48,6,,,,US_NY_36005,5443,1424,73
2020-03-25,1232,371,36,1054,289,30,594,185,20,1571,398,30,394,49,4,,,,US_NY_36005,6497,1713,103
2020-03-26,1357,441,49,999,305,37,627,215,34,1640,424,56,403,47,10,,,,US_NY_36005,7496,2018,140
2020-03-27,1406,400,73,1086,306,34,660,202,41,1574,411,56,371,57,7,,,,US_NY_36005,8582,2324,174
2020-03-28,849,354,75,763,301,61,387,204,28,1202,435,89,266,53,13,,,,US_NY_36005,9345,2625,235
2020-03-29,1121,412,87,699,310,54,408,160,35,1075,452,92,230,57,17,,,,US_NY_36005,10044,2935,289
2020-03-30,1747,496,106,1310,322,74,826,265,35,1839,548,96,397,68,10,,,,US_NY_36005,11354,3257,363
2020-03-31,1494,472,122,1285,357,93,642,224,43,1790,551,93,234,69,21,,,,US_NY_36005,12639,3614,456
2020-04-01,1593,468,131,1237,340,90,588,176,60,1765,522,135,263,73,16,,,,US_NY_36005,13876,3954,546
2020-04-02,1639,404,163,1284,339,95,659,230,63,1811,562,134,370,79,30,,,,US_NY_36005,15160,4293,641
2020-04-03,1443,403,136,1445,354,113,688,259,53,1752,517,154,344,64,29,,,,US_NY_36005,16605,4647,754
2020-04-04,917,342,152,1007,283,106,391,198,63,1199,465,148,347,51,20,,,,US_NY_36005,17612,4930,860
2020-04-05,1150,373,162,818,318,122,358,183,86,1136,387,177,323,65,22,,,,US_NY_36005,18430,5248,982
2020-04-06,1501,466,164,1512,383,109,719,260,69,1914,530,199,730,81,24,,,,US_NY_36005,19942,5631,1091
2020-04-07,1417,480,177,1466,333,114,607,195,90,1943,521,180,629,70,28,,,,US_NY_36005,21408,5964,1205
2020-04-08,1323,421,170,1295,370,106,557,177,65,1846,510,172,560,56,34,,,,US_NY_36005,22703,6334,1311
2020-04-09,1369,413,186,1280,302,108,567,201,64,1557,455,156,297,56,25,,,,US_NY_36005,23983,6636,1419
2020-04-10,1153,339,168,1232,304,118,505,195,68,1326,444,146,300,54,19,,,,US_NY_36005,25215,6940,1537
2020-04-11,1126,300,155,993,266,132,315,134,59,982,352,155,312,48,27,,,,US_NY_36005,26208,7206,1669
2020-04-12,701,260,199,758,237,106,254,143,63,920,307,163,252,45,26,,,,US_NY_36005,26966,7443,1775
2020-04-13,1063,340,157,693,279,118,394,187,73,974,350,178,185,56,25,,,,US_NY_36005,27659,7722,1893
2020-04-14,1035,274,153,1074,216,109,445,161,59,1299,382,160,290,52,24,,,,US_NY_36005,28733,7938,2002
2020-04-15,883,282,128,1063,222,92,435,146,55,1177,300,139,317,33,24,,,,US_NY_36005,29796,8160,2094
2020-04-16,884,247,123,932,199,84,360,110,58,1139,287,121,210,38,14,,,,US_NY_36005,30728,8359,2178
2020-04-17,958,258,116,910,194,85,333,125,42,1097,285,110,280,38,15,,,,US_NY_36005,31638,8553,2263
2020-04-18,574,175,113,548,156,58,188,89,56,704,213,116,153,25,19,,,,US_NY_36005,32186,8709,2321
2020-04-19,635,140,114,530,150,74,178,84,48,867,187,120,134,30,19,,,,US_NY_36005,32716,8859,2395
2020-04-20,980,213,94,975,164,77,384,94,50,1220,221,113,224,29,16,,,,US_NY_36005,33691,9023,2472
2020-04-21,899,174,91,637,148,68,374,100,47,934,210,87,216,27,11,,,,US_NY_36005,34328,9171,2540
2020-04-22,854,161,104,922,131,67,387,110,38,1109,177,76,173,20,14,,,,US_NY_36005,35250,9302,2607
2020-04-23,790,160,106,732,130,57,402,69,47,787,152,86,128,19,13,,,,US_NY_36005,35982,9432,2664
2020-04-24,628,141,93,579,115,61,413,94,50,774,165,81,143,34,13,,,,US_NY_36005,36561,9547,2725
2020-04-25,404,105,75,412,101,53,149,52,42,540,116,65,88,26,9,,,,US_NY_36005,36973,9648,2778
2020-04-26,332,88,60,194,87,52,99,51,33,332,126,78,46,23,7,,,,US_NY_36005,37167,9735,2830
2020-04-27,610,117,87,545,114,53,304,72,29,721,122,80,107,20,9,,,,US_NY_36005,37712,9849,2883
2020-04-28,715,123,57,668,109,55,324,72,36,893,119,63,129,19,8,,,,US_NY_36005,38380,9958,2938
2020-04-29,682,120,72,556,97,40,286,53,33,692,118,74,124,19,14,,,,US_NY_36005,38936,10055,2978
2020-04-30,599,96,65,478,70,45,218,42,34,592,112,57,130,19,11,,,,US_NY_36005,39414,10125,3023
2020-05-01,496,88,56,441,92,45,245,49,24,620,108,73,77,12,8,,,,US_NY_36005,39855,10217,3068
2020-05-02,264,63,46,259,63,49,141,29,23,333,88,58,60,18,12,,,,US_NY_36005,40114,10280,3117
2020-05-03,248,62,46,150,57,27,104,43,35,248,79,48,35,15,15,,,,US_NY_36005,40264,10337,3144
2020-05-04,463,90,42,347,68,35,214,54,19,432,82,49,90,15,8,,,,US_NY_36005,40611,10405,3179
2020-05-05,434,77,49,294,85,27,243,42,18,462,66,43,78,12,12,,,,US_NY_36005,40905,10490,3206
2020-05-06,451,76,38,281,71,28,166,36,17,443,66,53,60,7,8,,,,US_NY_36005,41186,10561,3234
2020-05-07,401,87,45,294,59,27,119,34,22,356,65,36,60,7,3,,,,US_NY_36005,41480,10620,3261
2020-05-08,349,79,42,252,71,21,100,41,13,343,53,45,42,10,5,,,,US_NY_36005,41732,10691,3282
2020-05-09,121,57,28,177,47,21,74,29,16,256,42,30,32,7,3,,,,US_NY_36005,41909,10738,3303
2020-05-10,191,43,25,75,36,13,94,28,20,85,38,30,14,5,8,,,,US_NY_36005,41984,10774,3316
2020-05-11,409,77,32,227,53,27,192,40,13,376,71,24,27,4,3,,,,US_NY_36005,42211,10827,3343
2020-05-12,400,57,33,354,52,20,163,30,14,314,53,15,53,8,6,,,,US_NY_36005,42565,10879,3363
2020-05-13,364,68,22,454,49,15,155,42,8,304,51,24,48,9,6,,,,US_NY_36005,43019,10928,3378
2020-05-14,332,61,14,255,47,9,149,32,16,333,63,21,41,13,6,,,,US_NY_36005,43274,10975,3387
2020-05-15,260,60,26,177,54,16,137,43,12,265,64,25,33,7,6,,,,US_NY_36005,43451,11029,3403
2020-05-16,164,48,23,110,30,27,56,18,9,135,60,20,25,9,2,,,,US_NY_36005,43561,11059,3430
2020-05-17,138,37,18,56,25,19,50,19,11,107,38,24,10,4,2,,,,US_NY_36005,43617,11084,3449
2020-05-18,270,59,15,185,35,11,133,31,10,274,49,17,38,4,2,,,,US_NY_36005,43802,11119,3460
2020-05-19,331,65,16,177,42,11,168,39,10,288,50,11,42,8,5,,,,US_NY_36005,43979,11161,3471
2020-05-20,326,49,20,275,39,15,165,25,12,247,45,22,57,6,7,,,,US_NY_36005,44254,11200,3486
2020-05-21,345,66,15,192,32,12,146,26,6,307,38,9,77,10,3,,,,US_NY_36005,44446,11232,3498
2020-05-22,387,61,13,259,42,12,156,35,5,226,51,28,32,7,5,,,,US_NY_36005,44705,11274,3510
2020-05-23,163,34,20,87,25,17,47,21,7,130,44,14,37,6,2,,,,US_NY_36005,44792,11299,3527
2020-05-24,181,35,12,96,26,13,70,28,6,118,28,11,14,4,5,,,,US_NY_36005,44888,11325,3540
2020-05-25,174,33,14,97,31,8,71,26,12,106,46,12,17,5,3,,,,US_NY_36005,44985,11356,3548
2020-05-26,339,34,10,270,41,10,127,27,7,261,45,9,56,3,1,,,,US_NY_36005,45255,11397,3558
2020-05-27,260,53,11,173,25,9,111,28,9,164,53,18,44,3,2,,,,US_NY_36005,45428,11422,3567
2020-05-28,227,48,13,110,23,12,96,29,3,172,33,9,26,8,1,,,,US_NY_36005,45538,11445,3579
2020-05-29,177,31,16,158,44,6,79,30,5,209,46,14,26,9,2,,,,US_NY_36005,45696,11489,3585
2020-05-30,110,29,10,75,25,12,39,12,12,107,24,17,15,3,1,,,,US_NY_36005,45771,11514,3597
2020-05-31,81,26,11,30,18,6,24,14,5,69,31,15,11,2,2,,,,US_NY_36005,45801,11532,3603
2020-06-01,253,37,10,151,26,3,81,23,3,139,35,14,39,2,3,,,,US_NY_36005,45952,11558,3606
2020-06-02,200,31,6,110,26,7,72,25,8,160,37,15,33,6,1,,,,US_NY_36005,46062,11584,3613
2020-06-03,144,39,13,100,19,10,78,25,7,147,26,8,42,5,3,,,,US_NY_36005,46162,11603,3623
2020-06-04,144,31,10,113,26,3,89,15,7,137,15,10,28,1,2,,,,US_NY_36005,46275,11629,3626
2020-06-05,132,19,6,102,16,7,60,10,7,104,17,5,9,1,1,,,,US_NY_36005,46377,11645,3633
2020-06-06,59,12,9,51,19,11,31,8,3,98,9,10,7,0,0,,,,US_NY_36005,46428,11664,3644
2020-06-07,53,15,5,42,18,7,23,6,1,74,6,10,4,0,1,,,,US_NY_36005,46470,11682,3651
2020-06-08,113,20,12,97,16,10,73,7,2,143,15,13,16,2,0,,,,US_NY_36005,46567,11698,3661
2020-06-09,131,18,7,79,16,6,67,7,8,127,8,9,19,1,2,,,,US_NY_36005,46646,11714,3667
2020-06-10,99,9,11,74,16,8,66,8,2,111,11,7,13,2,2,,,,US_NY_36005,46720,11730,3675
2020-06-11,107,13,5,60,12,5,61,4,2,110,9,7,15,0,1,,,,US_NY_36005,46780,11742,3680
2020-06-12,122,20,6,75,11,5,62,7,3,126,10,7,18,1,0,,,,US_NY_36005,46855,11753,3685
2020-06-13,52,9,4,43,6,4,24,3,2,73,7,1,1,1,1,,,,US_NY_36005,46898,11759,3689
2020-06-14,54,11,6,27,12,6,29,4,2,66,14,6,4,0,2,,,,US_NY_36005,46925,11771,3695
2020-06-15,98,21,4,65,13,5,61,5,2,115,10,4,17,0,2,,,,US_NY_36005,46990,11784,3700
2020-06-16,130,15,6,66,12,4,68,5,3,117,15,7,20,0,0,,,,US_NY_36005,47056,11796,3704
2020-06-17,98,13,7,65,12,2,68,5,3,89,12,7,16,0,0,,,,US_NY_36005,47121,11808,3706
2020-06-18,98,12,4,52,6,1,54,4,4,108,14,6,23,0,1,,,,US_NY_36005,47173,11814,3707
2020-06-19,77,21,3,70,8,3,47,4,3,108,3,3,4,0,2,,,,US_NY_36005,47243,11822,3710
2020-06-20,37,10,3,45,6,5,33,5,2,43,5,3,5,0,2,,,,US_NY_36005,47288,11828,3715
2020-06-21,36,11,3,18,6,5,14,3,4,41,7,7,7,2,2,,,,US_NY_36005,47306,11834,3720
2020-06-22,66,9,4,58,8,1,38,5,4,69,5,3,10,1,2,,,,US_NY_36005,47364,11842,3721
2020-06-23,29,1,2,26,10,3,30,2,2,51,5,1,6,1,0,,,,US_NY_36005,47390,11852,3724
2020-06-24,27,0,1,28,0,0,11,0,1,23,2,1,1,0,0,,,,US_NY_36005,47418,11852,3724
2020-06-25,1,0,0,3,0,0,1,0,0,5,0,0,0,0,0,,,,US_NY_36005,47421,11852,3724
2020-02-29,,,,0,4,0,1,2,0,0,2,0,0,0,0,0,3,0,US_NY_36047,0,4,0
2020-03-01,,,,0,0,0,0,0,0,0,2,0,0,1,0,1,1,0,US_NY_36047,0,4,0
2020-03-02,,,,0,4,0,0,4,0,0,5,0,0,0,0,0,9,0,US_NY_36047,0,8,0
2020-03-03,,,,0,5,0,0,2,0,1,5,0,0,1,0,1,7,0,US_NY_36047,0,13,0
2020-03-04,,,,1,5,0,2,6,0,2,3,0,0,2,0,0,6,0,US_NY_36047,1,18,0
2020-03-05,,,,3,5,0,0,6,0,0,6,0,0,1,0,0,2,0,US_NY_36047,4,23,0
2020-03-06,,,,1,3,0,3,3,0,1,5,0,1,2,0,2,5,0,US_NY_36047,5,26,0
2020-03-07,,,,2,6,0,1,4,0,3,3,0,1,0,0,0,2,0,US_NY_36047,7,32,0
2020-03-08,,,,5,9,0,6,1,0,5,5,0,1,0,0,4,2,0,US_NY_36047,12,41,0
2020-03-09,,,,16,15,0,25,12,0,10,8,0,3,3,0,4,11,0,US_NY_36047,28,56,0
2020-03-10,,,,11,13,0,24,13,0,24,23,0,2,5,0,8,8,0,US_NY_36047,39,69,0
2020-03-11,,,,31,15,0,61,21,0,40,30,1,3,3,0,19,20,0,US_NY_36047,70,84,0
2020-03-12,,,,96,26,0,137,11,0,80,29,0,13,5,0,29,16,0,US_NY_36047,166,110,0
2020-03-13,,,,166,36,0,182,27,0,166,48,0,26,3,0,79,34,0,US_NY_36047,332,146,0
2020-03-14,,,,163,36,1,179,28,0,194,57,1,22,8,0,86,26,0,US_NY_36047,495,182,1
2020-03-15,,,,430,43,0,209,30,2,230,64,1,46,16,1,118,34,1,US_NY_36047,925,225,1
2020-03-16,,,,739,83,1,458,40,0,530,106,4,91,17,0,303,65,3,US_NY_36047,1664,308,2
2020-03-17,,,,786,98,4,566,57,0,650,108,3,108,21,0,343,65,1,US_NY_36047,2450,406,6
2020-03-18,,,,970,111,6,540,76,4,832,152,9,150,23,0,483,100,1,US_NY_36047,3420,517,12
2020-03-19,,,,1209,147,6,554,91,4,1065,160,6,258,32,4,620,122,4,US_NY_36047,4629,664,18
2020-03-20,,,,1140,186,10,657,110,11,1184,223,9,309,30,3,719,111,13,US_NY_36047,5769,850,28
2020-03-21,,,,558,172,12,402,115,5,945,223,14,248,34,1,483,152,12,US_NY_36047,6327,1022,40
2020-03-22,,,,757,182,10,322,126,8,695,223,14,316,32,6,491,163,12,US_NY_36047,7084,1204,50
2020-03-23,,,,911,276,27,538,174,7,1189,332,28,209,46,8,723,207,12,US_NY_36047,7995,1480,77
2020-03-24,,,,1211,300,23,628,188,17,1389,361,34,349,48,6,927,253,14,US_NY_36047,9206,1780,100
2020-03-25,,,,1232,371,36,594,185,20,1571,398,30,394,49,4,1054,289,30,US_NY_36047,10438,2151,136
2020-03-26,,,,1357,441,49,627,215,34,1640,424,56,403,47,10,999,305,37,US_NY_36047,11795,2592,185
2020-03-27,,,,1406,400,73,660,202,41,1574,411,56,371,57,7,1086,306,34,US_NY_36047,13201,2992,258
2020-03-28,,,,849,354,75,387,204,28,1202,435,89,266,53,13,763,301,61,US_NY_36047,14050,3346,333
2020-03-29,,,,1121,412,87,408,160,35,1075,452,92,230,57,17,699,310,54,US_NY_36047,15171,3758,420
2020-03-30,,,,1747,496,106,826,265,35,1839,548,96,397,68,10,1310,322,74,US_NY_36047,16918,4254,526
2020-03-31,,,,1494,472,122,642,224,43,1790,551,93,234,69,21,1285,357,93,US_NY_36047,18412,4726,648
2020-04-01,,,,1593,468,131,588,176,60,1765,522,135,263,73,16,1237,340,90,US_NY_36047,20005,5194,779
2020-04-02,,,,1639,404,163,659,230,63,1811,562,134,370,79,30,1284,339,95,US_NY_36047,21644,5598,942
2020-04-03,,,,1443,403,136,688,259,53,1752,517,154,344,64,29,1445,354,113,US_NY_36047,23087,6001,1078
2020-04-04,,,,917,342,152,391,198,63,1199,465,148,347,51,20,1007,283,106,US_NY_36047,24004,6343,1230
2020-04-05,,,,1150,373,162,358,183,86,1136,387,177,323,65,22,818,318,122,US_NY_36047,25154,6716,1392
2020-04-06,,,,1501,466,164,719,260,69,1914,530,199,730,81,24,1512,383,109,US_NY_36047,26655,7182,1556
2020-04-07,,,,1417,480,177,607,195,90,1943,521,180,629,70,28,1466,333,114,US_NY_36047,28072,7662,1733
2020-04-08,,,,1323,421,170,557,177,65,1846,510,172,560,56,34,1295,370,106,US_NY_36047,29395,8083,1903
2020-04-09,,,,1369,413,186,567,201,64,1557,455,156,297,56,25,1280,302,108,US_NY_36047,30764,8496,2089
2020-04-10,,,,1153,339,168,505,195,68,1326,444,146,300,54,19,1232,304,118,US_NY_36047,31917,8835,2257
2020-04-11,,,,1126,300,155,315,134,59,982,352,155,312,48,27,993,266,132,US_NY_36047,33043,9135,2412
2020-04-12,,,,701,260,199,254,143,63,920,307,163,252,45,26,758,237,106,US_NY_36047,33744,9395,2611
2020-04-13,,,,1063,340,157,394,187,73,974,350,178,185,56,25,693,279,118,US_NY_36047,34807,9735,2768
2020-04-14,,,,1035,274,153,445,161,59,1299,382,160,290,52,24,1074,216,109,US_NY_36047,35842,10009,2921
2020-04-15,,,,883,282,128,435,146,55,1177,300,139,317,33,24,1063,222,92,US_NY_36047,36725,10291,3049
2020-04-16,,,,884,247,123,360,110,58,1139,287,121,210,38,14,932,199,84,US_NY_36047,37609,10538,3172
2020-04-17,,,,958,258,116,333,125,42,1097,285,110,280,38,15,910,194,85,US_NY_36047,38567,10796,3288
2020-04-18,,,,574,175,113,188,89,56,704,213,116,153,25,19,548,156,58,US_NY_36047,39141,10971,3401
2020-04-19,,,,635,140,114,178,84,48,867,187,120,134,30,19,530,150,74,US_NY_36047,39776,11111,3515
2020-04-20,,,,980,213,94,384,94,50,1220,221,113,224,29,16,975,164,77,US_NY_36047,40756,11324,3609
2020-04-21,,,,899,174,91,374,100,47,934,210,87,216,27,11,637,148,68,US_NY_36047,41655,11498,3700
2020-04-22,,,,854,161,104,387,110,38,1109,177,76,173,20,14,922,131,67,US_NY_36047,42509,11659,3804
2020-04-23,,,,790,160,106,402,69,47,787,152,86,128,19,13,732,130,57,US_NY_36047,43299,11819,3910
2020-04-24,,,,628,141,93,413,94,50,774,165,81,143,34,13,579,115,61,US_NY_36047,43927,11960,4003
2020-04-25,,,,404,105,75,149,52,42,540,116,65,88,26,9,412,101,53,US_NY_36047,44331,12065,4078
2020-04-26,,,,332,88,60,99,51,33,332,126,78,46,23,7,194,87,52,US_NY_36047,44663,12153,4138
2020-04-27,,,,610,117,87,304,72,29,721,122,80,107,20,9,545,114,53,US_NY_36047,45273,12270,4225
2020-04-28,,,,715,123,57,324,72,36,893,119,63,129,19,8,668,109,55,US_NY_36047,45988,12393,4282
2020-04-29,,,,682,120,72,286,53,33,692,118,74,124,19,14,556,97,40,US_NY_36047,46670,12513,4354
2020-04-30,,,,599,96,65,218,42,34,592,112,57,130,19,11,478,70,45,US_NY_36047,47269,12609,4419
2020-05-01,,,,496,88,56,245,49,24,620,108,73,77,12,8,441,92,45,US_NY_36047,47765,12697,4475
2020-05-02,,,,264,63,46,141,29,23,333,88,58,60,18,12,259,63,49,US_NY_36047,48029,12760,4521
2020-05-03,,,,248,62,46,104,43,35,248,79,48,35,15,15,150,57,27,US_NY_36047,48277,12822,4567
2020-05-04,,,,463,90,42,214,54,19,432,82,49,90,15,8,347,68,35,US_NY_36047,48740,12912,4609
2020-05-05,,,,434,77,49,243,42,18,462,66,43,78,12,12,294,85,27,US_NY_36047,49174,12989,4658
2020-05-06,,,,451,76,38,166,36,17,443,66,53,60,7,8,281,71,28,US_NY_36047,49625,13065,4696
2020-05-07,,,,401,87,45,119,34,22,356,65,36,60,7,3,294,59,27,US_NY_36047,50026,13152,4741
2020-05-08,,,,349,79,42,100,41,13,343,53,45,42,10,5,252,71,21,US_NY_36047,50375,13231,4783
2020-05-09,,,,121,57,28,74,29,16,256,42,30,32,7,3,177,47,21,US_NY_36047,50496,13288,4811
2020-05-10,,,,191,43,25,94,28,20,85,38,30,14,5,8,75,36,13,US_NY_36047,50687,13331,4836
2020-05-11,,,,409,77,32,192,40,13,376,71,24,27,4,3,227,53,27,US_NY_36047,51096,13408,4868
2020-05-12,,,,400,57,33,163,30,14,314,53,15,53,8,6,354,52,20,US_NY_36047,51496,13465,4901
2020-05-13,,,,364,68,22,155,42,8,304,51,24,48,9,6,454,49,15,US_NY_36047,51860,13533,4923
2020-05-14,,,,332,61,14,149,32,16,333,63,21,41,13,6,255,47,9,US_NY_36047,52192,13594,4937
2020-05-15,,,,260,60,26,137,43,12,265,64,25,33,7,6,177,54,16,US_NY_36047,52452,13654,4963
2020-05-16,,,,164,48,23,56,18,9,135,60,20,25,9,2,110,30,27,US_NY_36047,52616,13702,4986
2020-05-17,,,,138,37,18,50,19,11,107,38,24,10,4,2,56,25,19,US_NY_36047,52754,13739,5004
2020-05-18,,,,270,59,15,133,31,10,274,49,17,38,4,2,185,35,11,US_NY_36047,53024,13798,5019
2020-05-19,,,,331,65,16,168,39,10,288,50,11,42,8,5,177,42,11,US_NY_36047,53355,13863,5035
2020-05-20,,,,326,49,20,165,25,12,247,45,22,57,6,7,275,39,15,US_NY_36047,53681,13912,5055
2020-05-21,,,,345,66,15,146,26,6,307,38,9,77,10,3,192,32,12,US_NY_36047,54026,13978,5070
2020-05-22,,,,387,61,13,156,35,5,226,51,28,32,7,5,259,42,12,US_NY_36047,54413,14039,5083
2020-05-23,,,,163,34,20,47,21,7,130,44,14,37,6,2,87,25,17,US_NY_36047,54576,14073,5103
2020-05-24,,,,181,35,12,70,28,6,118,28,11,14,4,5,96,26,13,US_NY_36047,54757,14108,5115
2020-05-25,,,,174,33,14,71,26,12,106,46,12,17,5,3,97,31,8,US_NY_36047,54931,14141,5129
2020-05-26,,,,339,34,10,127,27,7,261,45,9,56,3,1,270,41,10,US_NY_36047,55270,14175,5139
2020-05-27,,,,260,53,11,111,28,9,164,53,18,44,3,2,173,25,9,US_NY_36047,55530,14228,5150
2020-05-28,,,,227,48,13,96,29,3,172,33,9,26,8,1,110,23,12,US_NY_36047,55757,14276,5163
2020-05-29,,,,177,31,16,79,30,5,209,46,14,26,9,2,158,44,6,US_NY_36047,55934,14307,5179
2020-05-30,,,,110,29,10,39,12,12,107,24,17,15,3,1,75,25,12,US_NY_36047,56044,14336,5189
2020-05-31,,,,81,26,11,24,14,5,69,31,15,11,2,2,30,18,6,US_NY_36047,56125,14362,5200
2020-06-01,,,,253,37,10,81,23,3,139,35,14,39,2,3,151,26,3,US_NY_36047,56378,14399,5210
2020-06-02,,,,200,31,6,72,25,8,160,37,15,33,6,1,110,26,7,US_NY_36047,56578,14430,5216
2020-06-03,,,,144,39,13,78,25,7,147,26,8,42,5,3,100,19,10,US_NY_36047,56722,14469,5229
2020-06-04,,,,144,31,10,89,15,7,137,15,10,28,1,2,113,26,3,US_NY_36047,56866,14500,5239
2020-06-05,,,,132,19,6,60,10,7,104,17,5,9,1,1,102,16,7,US_NY_36047,56998,14519,5245
2020-06-06,,,,59,12,9,31,8,3,98,9,10,7,0,0,51,19,11,US_NY_36047,57057,14531,5254
2020-06-07,,,,53,15,5,23,6,1,74,6,10,4,0,1,42,18,7,US_NY_36047,57110,14546,5259
2020-06-08,,,,113,20,12,73,7,2,143,15,13,16,2,0,97,16,10,US_NY_36047,57223,14566,5271
2020-06-09,,,,131,18,7,67,7,8,127,8,9,19,1,2,79,16,6,US_NY_36047,57354,14584,5278
2020-06-10,,,,99,9,11,66,8,2,111,11,7,13,2,2,74,16,8,US_NY_36047,57453,14593,5289
2020-06-11,,,,107,13,5,61,4,2,110,9,7,15,0,1,60,12,5,US_NY_36047,57560,14606,5294
2020-06-12,,,,122,20,6,62,7,3,126,10,7,18,1,0,75,11,5,US_NY_36047,57682,14626,5300
2020-06-13,,,,52,9,4,24,3,2,73,7,1,1,1,1,43,6,4,US_NY_36047,57734,14635,5304
2020-06-14,,,,54,11,6,29,4,2,66,14,6,4,0,2,27,12,6,US_NY_36047,57788,14646,5310
2020-06-15,,,,98,21,4,61,5,2,115,10,4,17,0,2,65,13,5,US_NY_36047,57886,14667,5314
2020-06-16,,,,130,15,6,68,5,3,117,15,7,20,0,0,66,12,4,US_NY_36047,58016,14682,5320
2020-06-17,,,,98,13,7,68,5,3,89,12,7,16,0,0,65,12,2,US_NY_36047,58114,14695,5327
2020-06-18,,,,98,12,4,54,4,4,108,14,6,23,0,1,52,6,1,US_NY_36047,58212,14707,5331
2020-06-19,,,,77,21,3,47,4,3,108,3,3,4,0,2,70,8,3,US_NY_36047,58289,14728,5334
2020-06-20,,,,37,10,3,33,5,2,43,5,3,5,0,2,45,6,5,US_NY_36047,58326,14738,5337
2020-06-21,,,,36,11,3,14,3,4,41,7,7,7,2,2,18,6,5,US_NY_36047,58362,14749,5340
2020-06-22,,,,66,9,4,38,5,4,69,5,3,10,1,2,58,8,1,US_NY_36047,58428,14758,5344
2020-06-23,,,,29,1,2,30,2,2,51,5,1,6,1,0,26,10,3,US_NY_36047,58457,14759,5346
2020-06-24,,,,27,0,1,11,0,1,23,2,1,1,0,0,28,0,0,US_NY_36047,58484,14759,5347
2020-06-25,,,,1,0,0,1,0,0,5,0,0,0,0,0,3,0,0,US_NY_36047,58485,14759,5347
2020-02-29,0,4,0,1,2,0,,,,0,2,0,0,0,0,0,3,0,US_NY_36061,1,2,0
2020-03-01,0,0,0,0,0,0,,,,0,2,0,0,1,0,1,1,0,US_NY_36061,1,2,0
2020-03-02,0,4,0,0,4,0,,,,0,5,0,0,0,0,0,9,0,US_NY_36061,1,6,0
2020-03-03,0,5,0,0,2,0,,,,1,5,0,0,1,0,1,7,0,US_NY_36061,1,8,0
2020-03-04,1,5,0,2,6,0,,,,2,3,0,0,2,0,0,6,0,US_NY_36061,3,14,0
2020-03-05,3,5,0,0,6,0,,,,0,6,0,0,1,0,0,2,0,US_NY_36061,3,20,0
2020-03-06,1,3,0,3,3,0,,,,1,5,0,1,2,0,2,5,0,US_NY_36061,6,23,0
2020-03-07,2,6,0,1,4,0,,,,3,3,0,1,0,0,0,2,0,US_NY_36061,7,27,0
2020-03-08,5,9,0,6,1,0,,,,5,5,0,1,0,0,4,2,0,US_NY_36061,13,28,0
2020-03-09,16,15,0,25,12,0,,,,10,8,0,3,3,0,4,11,0,US_NY_36061,38,40,0
2020-03-10,11,13,0,24,13,0,,,,24,23,0,2,5,0,8,8,0,US_NY_36061,62,53,0
2020-03-11,31,15,0,61,21,0,,,,40,30,1,3,3,0,19,20,0,US_NY_36061,123,74,0
2020-03-12,96,26,0,137,11,0,,,,80,29,0,13,5,0,29,16,0,US_NY_36061,260,85,0
2020-03-13,166,36,0,182,27,0,,,,166,48,0,26,3,0,79,34,0,US_NY_36061,442,112,0
2020-03-14,163,36,1,179,28,0,,,,194,57,1,22,8,0,86,26,0,US_NY_36061,621,140,0
2020-03-15,430,43,0,209,30,2,,,,230,64,1,46,16,1,118,34,1,US_NY_36061,830,170,2
2020-03-16,739,83,1,458,40,0,,,,530,106,4,91,17,0,303,65,3,US_NY_36061,1288,210,2
2020-03-17,786,98,4,566,57,0,,,,650,108,3,108,21,0,343,65,1,US_NY_36061,1854,267,2
2020-03-18,970,111,6,540,76,4,,,,832,152,9,150,23,0,483,100,1,US_NY_36061,2394,343,6
2020-03-19,1209,147,6,554,91,4,,,,1065,160,6,258,32,4,620,122,4,US_NY_36061,2948,434,10
2020-03-20,1140,186,10,657,110,11,,,,1184,223,9,309,30,3,719,111,13,US_NY_36061,3605,544,21
2020-03-21,558,172,12,402,115,5,,,,945,223,14,248,34,1,483,152,12,US_NY_36061,4007,659,26
2020-03-22,757,182,10,322,126,8,,,,695,223,14,316,32,6,491,163,12,US_NY_36061,4329,785,34
2020-03-23,911,276,27,538,174,7,,,,1189,332,28,209,46,8,723,207,12,US_NY_36061,4867,959,41
2020-03-24,1211,300,23,628,188,17,,,,1389,361,34,349,48,6,927,253,14,US_NY_36061,5495,1147,58
2020-03-25,1232,371,36,594,185,20,,,,1571,398,30,394,49,4,1054,289,30,US_NY_36061,6089,1332,78
2020-03-26,1357,441,49,627,215,34,,,,1640,424,56,403,47,10,999,305,37,US_NY_36061,6716,1547,112
2020-03-27,1406,400,73,660,202,41,,,,1574,411,56,371,57,7,1086,306,34,US_NY_36061,7376,1749,153
2020-03-28,849,354,75,387,204,28,,,,1202,435,89,266,53,13,763,301,61,US_NY_36061,7763,1953,181
2020-03-29,1121,412,87,408,160,35,,,,1075,452,92,230,57,17,699,310,54,US_NY_36061,8171,2113,216
2020-03-30,1747,496,106,826,265,35,,,,1839,548,96,397,68,10,1310,322,74,US_NY_36061,8997,2378,251
2020-03-31,1494,472,122,642,224,43,,,,1790,551,93,234,69,21,1285,357,93,US_NY_36061,9639,2602,294
2020-04-01,1593,468,131,588,176,60,,,,1765,522,135,263,73,16,1237,340,90,US_NY_36061,10227,2778,354
2020-04-02,1639,404,163,659,230,63,,,,1811,562,134,370,79,30,1284,339,95,US_NY_36061,10886,3008,417
2020-04-03,1443,403,136,688,259,53,,,,1752,517,154,344,64,29,1445,354,113,US_NY_36061,11574,3267,470
2020-04-04,917,342,152,391,198,63,,,,1199,465,148,347,51,20,1007,283,106,US_NY_36061,11965,3465,533
2020-04-05,1150,373,162,358,183,86,,,,1136,387,177,323,65,22,818,318,122,US_NY_36061,12323,3648,619
2020-04-06,1501,466,164,719,260,69,,,,1914,530,199,730,81,24,1512,383,109,US_NY_36061,13042,3908,688
2020-04-07,1417,480,177,607,195,90,,,,1943,521,180,629,70,28,1466,333,114,US_NY_36061,13649,4103,778
2020-04-08,1323,421,170,557,177,65,,,,1846,510,172,560,56,34,1295,370,106,US_NY_36061,14206,4280,843
2020-04-09,1369,413,186,567,201,64,,,,1557,455,156,297,56,25,1280,302,108,US_NY_36061,14773,4481,907
2020-04-10,1153,339,168,505,195,68,,,,1326,444,146,300,54,19,1232,304,118,US_NY_36061,15278,4676,975
2020-04-11,1126,300,155,315,134,59,,,,982,352,155,312,48,27,993,266,132,US_NY_36061,15593,4810,1034
2020-04-12,701,260,199,254,143,63,,,,920,307,163,252,45,26,758,237,106,US_NY_36061,15847,4953,1097
2020-04-13,1063,340,157,394,187,73,,,,974,350,178,185,56,25,693,279,118,US_NY_36061,16241,5140,1170
2020-04-14,1035,274,153,445,161,59,,,,1299,382,160,290,52,24,1074,216,109,US_NY_36061,16686,5301,1229
2020-04-15,883,282,128,435,146,55,,,,1177,300,139,317,33,24,1063,222,92,US_NY_36061,17121,5447,1284
2020-04-16,884,247,123,360,110,58,,,,1139,287,121,210,38,14,932,199,84,US_NY_36061,17481,5557,1342
2020-04-17,958,258,116,333,125,42,,,,1097,285,110,280,38,15,910,194,85,US_NY_36061,17814,5682,1384
2020-04-18,574,175,113,188,89,56,,,,704,213,116,153,25,19,548,156,58,US_NY_36061,18002,5771,1440
2020-04-19,635,140,114,178,84,48,,,,867,187,120,134,30,19,530,150,74,US_NY_36061,18180,5855,1488
2020-04-20,980,213,94,384,94,50,,,,1220,221,113,224,29,16,975,164,77,US_NY_36061,18564,5949,1538
2020-04-21,899,174,91,374,100,47,,,,934,210,87,216,27,11,637,148,68,US_NY_36061,18938,6049,1585
2020-04-22,854,161,104,387,110,38,,,,1109,177,76,173,20,14,922,131,67,US_NY_36061,19325,6159,1623
2020-04-23,790,160,106,402,69,47,,,,787,152,86,128,19,13,732,130,57,US_NY_36061,19727,6228,1670
2020-04-24,628,141,93,413,94,50,,,,774,165,81,143,34,13,579,115,61,US_NY_36061,20140,6322,1720
2020-04-25,404,105,75,149,52,42,,,,540,116,65,88,26,9,412,101,53,US_NY_36061,20289,6374,1762
2020-04-26,332,88,60,99,51,33,,,,332,126,78,46,23,7,194,87,52,US_NY_36061,20388,6425,1795
2020-04-27,610,117,87,304,72,29,,,,721,122,80,107,20,9,545,114,53,US_NY_36061,20692,6497,1824
2020-04-28,715,123,57,324,72,36,,,,893,119,63,129,19,8,668,109,55,US_NY_36061,21016,6569,1860
2020-04-29,682,120,72,286,53,33,,,,692,118,74,124,19,14,556,97,40,US_NY_36061,21302,6622,1893
2020-04-30,599,96,65,218,42,34,,,,592,112,57,130,19,11,478,70,45,US_NY_36061,21520,6664,1927
2020-05-01,496,88,56,245,49,24,,,,620,108,73,77,12,8,441,92,45,US_NY_36061,21765,6713,1951
2020-05-02,264,63,46,141,29,23,,,,333,88,58,60,18,12,259,63,49,US_NY_36061,21906,6742,1974
2020-05-03,248,62,46,104,43,35,,,,248,79,48,35,15,15,150,57,27,US_NY_36061,22010,6785,2009
2020-05-04,463,90,42,214,54,19,,,,432,82,49,90,15,8,347,68,35,US_NY_36061,22224,6839,2028
2020-05-05,434,77,49,243,42,18,,,,462,66,43,78,12,12,294,85,27,US_NY_36061,22467,6881,2046
2020-05-06,451,76,38,166,36,17,,,,443,66,53,60,7,8,281,71,28,US_NY_36061,22633,6917,2063
2020-05-07,401,87,45,119,34,22,,,,356,65,36,60,7,3,294,59,27,US_NY_36061,22752,6951,2085
2020-05-08,349,79,42,100,41,13,,,,343,53,45,42,10,5,252,71,21,US_NY_36061,22852,6992,2098
2020-05-09,121,57,28,74,29,16,,,,256,42,30,32,7,3,177,47,21,US_NY_36061,22926,7021,2114
2020-05-10,191,43,25,94,28,20,,,,85,38,30,14,5,8,75,36,13,US_NY_36061,23020,7049,2134
2020-05-11,409,77,32,192,40,13,,,,376,71,24,27,4,3,227,53,27,US_NY_36061,23212,7089,2147
2020-05-12,400,57,33,163,30,14,,,,314,53,15,53,8,6,354,52,20,US_NY_36061,23375,7119,2161
2020-05-13,364,68,22,155,42,8,,,,304,51,24,48,9,6,454,49,15,US_NY_36061,23530,7161,2169
2020-05-14,332,61,14,149,32,16,,,,333,63,21,41,13,6,255,47,9,US_NY_36061,23679,7193,2185
2020-05-15,260,60,26,137,43,12,,,,265,64,25,33,7,6,177,54,16,US_NY_36061,23816,7236,2197
2020-05-16,164,48,23,56,18,9,,,,135,60,20,25,9,2,110,30,27,US_NY_36061,23872,7254,2206
2020-05-17,138,37,18,50,19,11,,,,107,38,24,10,4,2,56,25,19,US_NY_36061,23922,7273,2217
2020-05-18,270,59,15,133,31,10,,,,274,49,17,38,4,2,185,35,11,US_NY_36061,24055,7304,2227
2020-05-19,331,65,16,168,39,10,,,,288,50,11,42,8,5,177,42,11,US_NY_36061,24223,7343,2237
2020-05-20,326,49,20,165,25,12,,,,247,45,22,57,6,7,275,39,15,US_NY_36061,24388,7368,2249
2020-05-21,345,66,15,146,26,6,,,,307,38,9,77,10,3,192,32,12,US_NY_36061,24534,7394,2255
2020-05-22,387,61,13,156,35,5,,,,226,51,28,32,7,5,259,42,12,US_NY_36061,24690,7429,2260
2020-05-23,163,34,20,47,21,7,,,,130,44,14,37,6,2,87,25,17,US_NY_36061,24737,7450,2267
2020-05-24,181,35,12,70,28,6,,,,118,28,11,14,4,5,96,26,13,US_NY_36061,24807,7478,2273
2020-05-25,174,33,14,71,26,12,,,,106,46,12,17,5,3,97,31,8,US_NY_36061,24878,7504,2285
2020-05-26,339,34,10,127,27,7,,,,261,45,9,56,3,1,270,41,10,US_NY_36061,25005,7531,2292
2020-05-27,260,53,11,111,28,9,,,,164,53,18,44,3,2,173,25,9,US_NY_36061,25116,7559,2301
2020-05-28,227,48,13,96,29,3,,,,172,33,9,26,8,1,110,23,12,US_NY_36061,25212,7588,2304
2020-05-29,177,31,16,79,30,5,,,,209,46,14,26,9,2,158,44,6,US_NY_36061,25291,7618,2309
2020-05-30,110,29,10,39,12,12,,,,107,24,17,15,3,1,75,25,12,US_NY_36061,25330,7630,2321
2020-05-31,81,26,11,24,14,5,,,,69,31,15,11,2,2,30,18,6,US_NY_36061,25354,7644,2326
2020-06-01,253,37,10,81,23,3,,,,139,35,14,39,2,3,151,26,3,US_NY_36061,25435,7667,2329
2020-06-02,200,31,6,72,25,8,,,,160,37,15,33,6,1,110,26,7,US_NY_36061,25507,7692,2337
2020-06-03,144,39,13,78,25,7,,,,147,26,8,42,5,3,100,19,10,US_NY_36061,25585,7717,2344
2020-06-04,144,31,10,89,15,7,,,,137,15,10,28,1,2,113,26,3,US_NY_36061,25674,7732,2351
2020-06-05,132,19,6,60,10,7,,,,104,17,5,9,1,1,102,16,7,US_NY_36061,25734,7742,2358
2020-06-06,59,12,9,31,8,3,,,,98,9,10,7,0,0,51,19,11,US_NY_36061,25765,7750,2361
2020-06-07,53,15,5,23,6,1,,,,74,6,10,4,0,1,42,18,7,US_NY_36061,25788,7756,2362
2020-06-08,113,20,12,73,7,2,,,,143,15,13,16,2,0,97,16,10,US_NY_36061,25861,7763,2364
2020-06-09,131,18,7,67,7,8,,,,127,8,9,19,1,2,79,16,6,US_NY_36061,25928,7770,2372
2020-06-10,99,9,11,66,8,2,,,,111,11,7,13,2,2,74,16,8,US_NY_36061,25994,7778,2374
2020-06-11,107,13,5,61,4,2,,,,110,9,7,15,0,1,60,12,5,US_NY_36061,26055,7782,2376
2020-06-12,122,20,6,62,7,3,,,,126,10,7,18,1,0,75,11,5,US_NY_36061,26117,7789,2379
2020-06-13,52,9,4,24,3,2,,,,73,7,1,1,1,1,43,6,4,US_NY_36061,26141,7792,2381
2020-06-14,54,11,6,29,4,2,,,,66,14,6,4,0,2,27,12,6,US_NY_36061,26170,7796,2383
2020-06-15,98,21,4,61,5,2,,,,115,10,4,17,0,2,65,13,5,US_NY_36061,26231,7801,2385
2020-06-16,130,15,6,68,5,3,,,,117,15,7,20,0,0,66,12,4,US_NY_36061,26299,7806,2388
2020-06-17,98,13,7,68,5,3,,,,89,12,7,16,0,0,65,12,2,US_NY_36061,26367,7811,2391
2020-06-18,98,12,4,54,4,4,,,,108,14,6,23,0,1,52,6,1,US_NY_36061,26421,7815,2395
2020-06-19,77,21,3,47,4,3,,,,108,3,3,4,0,2,70,8,3,US_NY_36061,26468,7819,2398
2020-06-20,37,10,3,33,5,2,,,,43,5,3,5,0,2,45,6,5,US_NY_36061,26501,7824,2400
2020-06-21,36,11,3,14,3,4,,,,41,7,7,7,2,2,18,6,5,US_NY_36061,26515,7827,2404
2020-06-22,66,9,4,38,5,4,,,,69,5,3,10,1,2,58,8,1,US_NY_36061,26553,7832,2408
2020-06-23,29,1,2,30,2,2,,,,51,5,1,6,1,0,26,10,3,US_NY_36061,26583,7834,2410
2020-06-24,27,0,1,11,0,1,,,,23,2,1,1,0,0,28,0,0,US_NY_36061,26594,7834,2411
2020-06-25,1,0,0,1,0,0,,,,5,0,0,0,0,0,3,0,0,US_NY_36061,26595,7834,2411
2020-02-29,0,4,0,0,2,0,1,2,0,,,,0,0,0,0,3,0,US_NY_36081,0,2,0
2020-03-01,0,0,0,0,2,0,0,0,0,,,,0,1,0,1,1,0,US_NY_36081,0,4,0
2020-03-02,0,4,0,0,5,0,0,4,0,,,,0,0,0,0,9,0,US_NY_36081,0,9,0
2020-03-03,0,5,0,1,5,0,0,2,0,,,,0,1,0,1,7,0,US_NY_36081,1,14,0
2020-03-04,1,5,0,2,3,0,2,6,0,,,,0,2,0,0,6,0,US_NY_36081,3,17,0
2020-03-05,3,5,0,0,6,0,0,6,0,,,,0,1,0,0,2,0,US_NY_36081,3,23,0
2020-03-06,1,3,0,1,5,0,3,3,0,,,,1,2,0,2,5,0,US_NY_36081,4,28,0
2020-03-07,2,6,0,3,3,0,1,4,0,,,,1,0,0,0,2,0,US_NY_36081,7,31,0
2020-03-08,5,9,0,5,5,0,6,1,0,,,,1,0,0,4,2,0,US_NY_36081,12,36,0
2020-03-09,16,15,0,10,8,0,25,12,0,,,,3,3,0,4,11,0,US_NY_36081,22,44,0
2020-03-10,11,13,0,24,23,0,24,13,0,,,,2,5,0,8,8,0,US_NY_36081,46,67,0
2020-03-11,31,15,0,40,30,1,61,21,0,,,,3,3,0,19,20,0,US_NY_36081,86,97,1
2020-03-12,96,26,0,80,29,0,137,11,0,,,,13,5,0,29,16,0,US_NY_36081,166,126,1
2020-03-13,166,36,0,166,48,0,182,27,0,,,,26,3,0,79,34,0,US_NY_36081,332,174,1
2020-03-14,163,36,1,194,57,1,179,28,0,,,,22,8,0,86,26,0,US_NY_36081,526,231,2
2020-03-15,430,43,0,230,64,1,209,30,2,,,,46,16,1,118,34,1,US_NY_36081,756,295,3
2020-03-16,739,83,1,530,106,4,458,40,0,,,,91,17,0,303,65,3,US_NY_36081,1286,401,7
2020-03-17,786,98,4,650,108,3,566,57,0,,,,108,21,0,343,65,1,US_NY_36081,1936,509,10
2020-03-18,970,111,6,832,152,9,540,76,4,,,,150,23,0,483,100,1,US_NY_36081,2768,661,19
2020-03-19,1209,147,6,1065,160,6,554,91,4,,,,258,32,4,620,122,4,US_NY_36081,3833,821,25
2020-03-20,1140,186,10,1184,223,9,657,110,11,,,,309,30,3,719,111,13,US_NY_36081,5017,1044,34
2020-03-21,558,172,12,945,223,14,402,115,5,,,,248,34,1,483,152,12,US_NY_36081,5962,1267,48
2020-03-22,757,182,10,695,223,14,322,126,8,,,,316,32,6,491,163,12,US_NY_36081,6657,1490,62
2020-03-23,911,276,27,1189,332,28,538,174,7,,,,209,46,8,723,207,12,US_NY_36081,7846,1822,90
2020-03-24,1211,300,23,1389,361,34,628,188,17,,,,349,48,6,927,253,14,US_NY_36081,9235,2183,124
2020-03-25,1232,371,36,1571,398,30,594,185,20,,,,394,49,4,1054,289,30,US_NY_36081,10806,2581,154
2020-03-26,1357,441,49,1640,424,56,627,215,34,,,,403,47,10,999,305,37,US_NY_36081,12446,3005,210
2020-03-27,1406,400,73,1574,411,56,660,202,41,,,,371,57,7,1086,306,34,US_NY_36081,14020,3416,266
2020-03-28,849,354,75,1202,435,89,387,204,28,,,,266,53,13,763,301,61,US_NY_36081,15222,3851,355
2020-03-29,1121,412,87,1075,452,92,408,160,35,,,,230,57,17,699,310,54,US_NY_36081,16297,4303,447
2020-03-30,1747,496,106,1839,548,96,826,265,35,,,,397,68,10,1310,322,74,US_NY_36081,18136,4851,543
2020-03-31,1494,472,122,1790,551,93,642,224,43,,,,234,69,21,1285,357,93,US_NY_36081,19926,5402,636
2020-04-01,1593,468,131,1765,522,135,588,176,60,,,,263,73,16,1237,340,90,US_NY_36081,21691,5924,771
2020-04-02,1639,404,163,1811,562,134,659,230,63,,,,370,79,30,1284,339,95,US_NY_36081,23502,6486,905
2020-04-03,1443,403,136,1752,517,154,688,259,53,,,,344,64,29,1445,354,113,US_NY_36081,25254,7003,1059
2020-04-04,917,342,152,1199,465,148,391,198,63,,,,347,51,20,1007,283,106,US_NY_36081,26453,7468,1207
2020-04-05,1150,373,162,1136,387,177,358,183,86,,,,323,65,22,818,318,122,US_NY_36081,27589,7855,1384
2020-04-06,1501,466,164,1914,530,199,719,260,69,,,,730,81,24,1512,383,109,US_NY_36081,29503,8385,1583
2020-04-07,1417,480,177,1943,521,180,607,195,90,,,,629,70,28,1466,333,114,US_NY_36081,31446,8906,1763
2020-04-08,1323,421,170,1846,510,172,557,177,65,,,,560,56,34,1295,370,106,US_NY_36081,33292,9416,1935
2020-04-09,1369,413,186,1557,455,156,567,201,64,,,,297,56,25,1280,302,108,US_NY_36081,34849,9871,2091
2020-04-10,1153,339,168,1326,444,146,505,195,68,,,,300,54,19,1232,304,118,US_NY_36081,36175,10315,2237
2020-04-11,1126,300,155,982,352,155,315,134,59,,,,312,48,27,993,266,132,US_NY_36081,37157,10667,2392
2020-04-12,701,260,199,920,307,163,254,143,63,,,,252,45,26,758,237,106,US_NY_36081,38077,10974,2555
2020-04-13,1063,340,157,974,350,178,394,187,73,,,,185,56,25,693,279,118,US_NY_36081,39051,11324,2733
2020-04-14,1035,274,153,1299,382,160,445,161,59,,,,290,52,24,1074,216,109,US_NY_36081,40350,11706,2893
2020-04-15,883,282,128,1177,300,139,435,146,55,,,,317,33,24,1063,222,92,US_NY_36081,41527,12006,3032
2020-04-16,884,247,123,1139,287,121,360,110,58,,,,210,38,14,932,199,84,US_NY_36081,42666,12293,3153
2020-04-17,958,258,116,1097,285,110,333,125,42,,,,280,38,15,910,194,85,US_NY_36081,43763,12578,3263
2020-04-18,574,175,113,704,213,116,188,89,56,,,,153,25,19,548,156,58,US_NY_36081,44467,12791,3379
2020-04-19,635,140,114,867,187,120,178,84,48,,,,134,30,19,530,150,74,US_NY_36081,45334,12978,3499
2020-04-20,980,213,94,1220,221,113,384,94,50,,,,224,29,16,975,164,77,US_NY_36081,46554,13199,3612
2020-04-21,899,174,91,934,210,87,374,100,47,,,,216,27,11,637,148,68,US_NY_36081,47488,13409,3699
2020-04-22,854,161,104,1109,177,76,387,110,38,,,,173,20,14,922,131,67,US_NY_36081,48597,13586,3775
2020-04-23,790,160,106,787,152,86,402,69,47,,,,128,19,13,732,130,57,US_NY_36081,49384,13738,3861
2020-04-24,628,141,93,774,165,81,413,94,50,,,,143,34,13,579,115,61,US_NY_36081,50158,13903,3942
2020-04-25,404,105,75,540,116,65,149,52,42,,,,88,26,9,412,101,53,US_NY_36081,50698,14019,4007
2020-04-26,332,88,60,332,126,78,99,51,33,,,,46,23,7,194,87,52,US_NY_36081,51030,14145,4085
2020-04-27,610,117,87,721,122,80,304,72,29,,,,107,20,9,545,114,53,US_NY_36081,51751,14267,4165
2020-04-28,715,123,57,893,119,63,324,72,36,,,,129,19,8,668,109,55,US_NY_36081,52644,14386,4228
2020-04-29,682,120,72,692,118,74,286,53,33,,,,124,19,14,556,97,40,US_NY_36081,53336,14504,4302
2020-04-30,599,96,65,592,112,57,218,42,34,,,,130,19,11,478,70,45,US_NY_36081,53928,14616,4359
2020-05-01,496,88,56,620,108,73,245,49,24,,,,77,12,8,441,92,45,US_NY_36081,54548,14724,4432
2020-05-02,264,63,46,333,88,58,141,29,23,,,,60,18,12,259,63,49,US_NY_36081,54881,14812,4490
2020-05-03,248,62,46,248,79,48,104,43,35,,,,35,15,15,150,57,27,US_NY_36081,55129,14891,4538
2020-05-04,463,90,42,432,82,49,214,54,19,,,,90,15,8,347,68,35,US_NY_36081,55561,14973,4587
2020-05-05,434,77,49,462,66,43,243,42,18,,,,78,12,12,294,85,27,US_NY_36081,56023,15039,4630
2020-05-06,451,76,38,443,66,53,166,36,17,,,,60,7,8,281,71,28,US_NY_36081,56466,15105,4683
2020-05-07,401,87,45,356,65,36,119,34,22,,,,60,7,3,294,59,27,US_NY_36081,56822,15170,4719
2020-05-08,349,79,42,343,53,45,100,41,13,,,,42,10,5,252,71,21,US_NY_36081,57165,15223,4764
2020-05-09,121,57,28,256,42,30,74,29,16,,,,32,7,3,177,47,21,US_NY_36081,57421,15265,4794
2020-05-10,191,43,25,85,38,30,94,28,20,,,,14,5,8,75,36,13,US_NY_36081,57506,15303,4824
2020-05-11,409,77,32,376,71,24,192,40,13,,,,27,4,3,227,53,27,US_NY_36081,57882,15374,4848
2020-05-12,400,57,33,314,53,15,163,30,14,,,,53,8,6,354,52,20,US_NY_36081,58196,15427,4863
2020-05-13,364,68,22,304,51,24,155,42,8,,,,48,9,6,454,49,15,US_NY_36081,58500,15478,4887
2020-05-14,332,61,14,333,63,21,149,32,16,,,,41,13,6,255,47,9,US_NY_36081,58833,15541,4908
2020-05-15,260,60,26,265,64,25,137,43,12,,,,33,7,6,177,54,16,US_NY_36081,59098,15605,4933
2020-05-16,164,48,23,135,60,20,56,18,9,,,,25,9,2,110,30,27,US_NY_36081,59233,15665,4953
2020-05-17,138,37,18,107,38,24,50,19,11,,,,10,4,2,56,25,19,US_NY_36081,59340,15703,4977
2020-05-18,270,59,15,274,49,17,133,31,10,,,,38,4,2,185,35,11,US_NY_36081,59614,15752,4994
2020-05-19,331,65,16,288,50,11,168,39,10,,,,42,8,5,177,42,11,US_NY_36081,59902,15802,5005
2020-05-20,326,49,20,247,45,22,165,25,12,,,,57,6,7,275,39,15,US_NY_36081,60149,15847,5027
2020-05-21,345,66,15,307,38,9,146,26,6,,,,77,10,3,192,32,12,US_NY_36081,60456,15885,5036
2020-05-22,387,61,13,226,51,28,156,35,5,,,,32,7,5,259,42,12,US_NY_36081,60682,15936,5064
2020-05-23,163,34,20,130,44,14,47,21,7,,,,37,6,2,87,25,17,US_NY_36081,60812,15980,5078
2020-05-24,181,35,12,118,28,11,70,28,6,,,,14,4,5,96,26,13,US_NY_36081,60930,16008,5089
2020-05-25,174,33,14,106,46,12,71,26,12,,,,17,5,3,97,31,8,US_NY_36081,61036,16054,5101
2020-05-26,339,34,10,261,45,9,127,27,7,,,,56,3,1,270,41,10,US_NY_36081,61297,16099,5110
2020-05-27,260,53,11,164,53,18,111,28,9,,,,44,3,2,173,25,9,US_NY_36081,61461,16152,5128
2020-05-28,227,48,13,172,33,9,96,29,3,,,,26,8,1,110,23,12,US_NY_36081,61633,16185,5137
2020-05-29,177,31,16,209,46,14,79,30,5,,,,26,9,2,158,44,6,US_NY_36081,61842,16231,5151
2020-05-30,110,29,10,107,24,17,39,12,12,,,,15,3,1,75,25,12,US_NY_36081,61949,16255,5168
2020-05-31,81,26,11,69,31,15,24,14,5,,,,11,2,2,30,18,6,US_NY_36081,62018,16286,5183
2020-06-01,253,37,10,139,35,14,81,23,3,,,,39,2,3,151,26,3,US_NY_36081,62157,16321,5197
2020-06-02,200,31,6,160,37,15,72,25,8,,,,33,6,1,110,26,7,US_NY_36081,62317,16358,5212
2020-06-03,144,39,13,147,26,8,78,25,7,,,,42,5,3,100,19,10,US_NY_36081,62464,16384,5220
2020-06-04,144,31,10,137,15,10,89,15,7,,,,28,1,2,113,26,3,US_NY_36081,62601,16399,5230
2020-06-05,132,19,6,104,17,5,60,10,7,,,,9,1,1,102,16,7,US_NY_36081,62705,16416,5235
2020-06-06,59,12,9,98,9,10,31,8,3,,,,7,0,0,51,19,11,US_NY_36081,62803,16425,5245
2020-06-07,53,15,5,74,6,10,23,6,1,,,,4,0,1,42,18,7,US_NY_36081,62877,16431,5255
2020-06-08,113,20,12,143,15,13,73,7,2,,,,16,2,0,97,16,10,US_NY_36081,63020,16446,5268
2020-06-09,131,18,7,127,8,9,67,7,8,,,,19,1,2,79,16,6,US_NY_36081,63147,16454,5277
2020-06-10,99,9,11,111,11,7,66,8,2,,,,13,2,2,74,16,8,US_NY_36081,63258,16465,5284
2020-06-11,107,13,5,110,9,7,61,4,2,,,,15,0,1,60,12,5,US_NY_36081,63368,16474,5291
2020-06-12,122,20,6,126,10,7,62,7,3,,,,18,1,0,75,11,5,US_NY_36081,63494,16484,5298
2020-06-13,52,9,4,73,7,1,24,3,2,,,,1,1,1,43,6,4,US_NY_36081,63567,16491,5299
2020-06-14,54,11,6,66,14,6,29,4,2,,,,4,0,2,27,12,6,US_NY_36081,63633,16505,5305
2020-06-15,98,21,4,115,10,4,61,5,2,,,,17,0,2,65,13,5,US_NY_36081,63748,16515,5309
2020-06-16,130,15,6,117,15,7,68,5,3,,,,20,0,0,66,12,4,US_NY_36081,63865,16530,5316
2020-06-17,98,13,7,89,12,7,68,5,3,,,,16,0,0,65,12,2,US_NY_36081,63954,16542,5323
2020-06-18,98,12,4,108,14,6,54,4,4,,,,23,0,1,52,6,1,US_NY_36081,64062,16556,5329
2020-06-19,77,21,3,108,3,3,47,4,3,,,,4,0,2,70,8,3,US_NY_36081,64170,16559,5332
2020-06-20,37,10,3,43,5,3,33,5,2,,,,5,0,2,45,6,5,US_NY_36081,64213,16564,5335
2020-06-21,36,11,3,41,7,7,14,3,4,,,,7,2,2,18,6,5,US_NY_36081,64254,16571,5342
2020-06-22,66,9,4,69,5,3,38,5,4,,,,10,1,2,58,8,1,US_NY_36081,64323,16576,5345
2020-06-23,29,1,2,51,5,1,30,2,2,,,,6,1,0,26,10,3,US_NY_36081,64374,16581,5346
2020-06-24,27,0,1,23,2,1,11,0,1,,,,1,0,0,28,0,0,US_NY_36081,64397,16583,5347
2020-06-25,1,0,0,5,0,0,1,0,0,,,,0,0,0,3,0,0,US_NY_36081,64402,16583,5347
2020-02-29,0,4,0,0,0,0,1,2,0,0,2,0,,,,0,3,0,US_NY_36085,0,0,0
2020-03-01,0,0,0,0,1,0,0,0,0,0,2,0,,,,1,1,0,US_NY_36085,0,1,0
2020-03-02,0,4,0,0,0,0,0,4,0,0,5,0,,,,0,9,0,US_NY_36085,0,1,0
2020-03-03,0,5,0,0,1,0,0,2,0,1,5,0,,,,1,7,0,US_NY_36085,0,2,0
2020-03-04,1,5,0,0,2,0,2,6,0,2,3,0,,,,0,6,0,US_NY_36085,0,4,0
2020-03-05,3,5,0,0,1,0,0,6,0,0,6,0,,,,0,2,0,US_NY_36085,0,5,0
2020-03-06,1,3,0,1,2,0,3,3,0,1,5,0,,,,2,5,0,US_NY_36085,1,7,0
2020-03-07,2,6,0,1,0,0,1,4,0,3,3,0,,,,0,2,0,US_NY_36085,2,7,0
2020-03-08,5,9,0,1,0,0,6,1,0,5,5,0,,,,4,2,0,US_NY_36085,3,7,0
2020-03-09,16,15,0,3,3,0,25,12,0,10,8,0,,,,4,11,0,US_NY_36085,6,10,0
2020-03-10,11,13,0,2,5,0,24,13,0,24,23,0,,,,8,8,0,US_NY_36085,8,15,0
2020-03-11,31,15,0,3,3,0,61,21,0,40,30,1,,,,19,20,0,US_NY_36085,11,18,0
2020-03-12,96,26,0,13,5,0,137,11,0,80,29,0,,,,29,16,0,US_NY_36085,24,23,0
2020-03-13,166,36,0,26,3,0,182,27,0,166,48,0,,,,79,34,0,US_NY_36085,50,26,0
2020-03-14,163,36,1,22,8,0,179,28,0,194,57,1,,,,86,26,0,US_NY_36085,72,34,0
2020-03-15,430,43,0,46,16,1,209,30,2,230,64,1,,,,118,34,1,US_NY_36085,118,50,1
2020-03-16,739,83,1,91,17,0,458,40,0,530,106,4,,,,303,65,3,US_NY_36085,209,67,1
2020-03-17,786,98,4,108,21,0,566,57,0,650,108,3,,,,343,65,1,US_NY_36085,317,88,1
2020-03-18,970,111,6,150,23,0,540,76,4,832,152,9,,,,483,100,1,US_NY_36085,467,111,1
2020-03-19,1209,147,6,258,32,4,554,91,4,1065,160,6,,,,620,122,4,US_NY_36085,725,143,5
2020-03-20,1140,186,10,309,30,3,657,110,11,1184,223,9,,,,719,111,13,US_NY_36085,1034,173,8
2020-03-21,558,172,12,248,34,1,402,115,5,945,223,14,,,,483,152,12,US_NY_36085,1282,207,9
2020-03-22,757,182,10,316,32,6,322,126,8,695,223,14,,,,491,163,12,US_NY_36085,1598,239,15
2020-03-23,911,276,27,209,46,8,538,174,7,1189,332,28,,,,723,207,12,US_NY_36085,1807,285,23
2020-03-24,1211,300,23,349,48,6,628,188,17,1389,361,34,,,,927,253,14,US_NY_36085,2156,333,29
2020-03-25,1232,371,36,394,49,4,594,185,20,1571,398,30,,,,1054,289,30,US_NY_36085,2550,382,33
2020-03-26,1357,441,49,403,47,10,627,215,34,1640,424,56,,,,999,305,37,US_NY_36085,2953,429,43
2020-03-27,1406,400,73,371,57,7,660,202,41,1574,411,56,,,,1086,306,34,US_NY_36085,3324,486,50
2020-03-28,849,354,75,266,53,13,387,204,28,1202,435,89,,,,763,301,61,US_NY_36085,3590,539,63
2020-03-29,1121,412,87,230,57,17,408,160,35,1075,452,92,,,,699,310,54,US_NY_36085,3820,596,80
2020-03-30,1747,496,106,397,68,10,826,265,35,1839,548,96,,,,1310,322,74,US_NY_36085,4217,664,90
2020-03-31,1494,472,122,234,69,21,642,224,43,1790,551,93,,,,1285,357,93,US_NY_36085,4451,733,111
2020-04-01,1593,468,131,263,73,16,588,176,60,1765,522,135,,,,1237,340,90,US_NY_36085,4714,806,127
2020-04-02,1639,404,163,370,79,30,659,230,63,1811,562,134,,,,1284,339,95,US_NY_36085,5084,885,157
2020-04-03,1443,403,136,344,64,29,688,259,53,1752,517,154,,,,1445,354,113,US_NY_36085,5428,949,186
2020-04-04,917,342,152,347,51,20,391,198,63,1199,465,148,,,,1007,283,106,US_NY_36085,5775,1000,206
2020-04-05,1150,373,162,323,65,22,358,183,86,1136,387,177,,,,818,318,122,US_NY_36085,6098,1065,228
2020-04-06,1501,466,164,730,81,24,719,260,69,1914,530,199,,,,1512,383,109,US_NY_36085,6828,1146,252
2020-04-07,1417,480,177,629,70,28,607,195,90,1943,521,180,,,,1466,333,114,US_NY_36085,7457,1216,280
2020-04-08,1323,421,170,560,56,34,557,177,65,1846,510,172,,,,1295,370,106,US_NY_36085,8017,1272,314
2020-04-09,1369,413,186,297,56,25,567,201,64,1557,455,156,,,,1280,302,108,US_NY_36085,8314,1328,339
2020-04-10,1153,339,168,300,54,19,505,195,68,1326,444,146,,,,1232,304,118,US_NY_36085,8614,1382,358
2020-04-11,1126,300,155,312,48,27,315,134,59,982,352,155,,,,993,266,132,US_NY_36085,8926,1430,385
2020-04-12,701,260,199,252,45,26,254,143,63,920,307,163,,,,758,237,106,US_NY_36085,9178,1475,411
2020-04-13,1063,340,157,185,56,25,394,187,73,974,350,178,,,,693,279,118,US_NY_36085,9363,1531,436
2020-04-14,1035,274,153,290,52,24,445,161,59,1299,382,160,,,,1074,216,109,US_NY_36085,9653,1583,460
2020-04-15,883,282,128,317,33,24,435,146,55,1177,300,139,,,,1063,222,92,US_NY_36085,9970,1616,484
2020-04-16,884,247,123,210,38,14,360,110,58,1139,287,121,,,,932,199,84,US_NY_36085,10180,1654,498
2020-04-17,958,258,116,280,38,15,333,125,42,1097,285,110,,,,910,194,85,US_NY_36085,10460,1692,513
2020-04-18,574,175,113,153,25,19,188,89,56,704,213,116,,,,548,156,58,US_NY_36085,10613,1717,532
2020-04-19,635,140,114,134,30,19,178,84,48,867,187,120,,,,530,150,74,US_NY_36085,10747,1747,551
2020-04-20,980,213,94,224,29,16,384,94,50,1220,221,113,,,,975,164,77,US_NY_36085,10971,1776,567
2020-04-21,899,174,91,216,27,11,374,100,47,934,210,87,,,,637,148,68,US_NY_36085,11187,1803,578
2020-04-22,854,161,104,173,20,14,387,110,38,1109,177,76,,,,922,131,67,US_NY_36085,11360,1823,592
2020-04-23,790,160,106,128,19,13,402,69,47,787,152,86,,,,732,130,57,US_NY_36085,11488,1842,605
2020-04-24,628,141,93,143,34,13,413,94,50,774,165,81,,,,579,115,61,US_NY_36085,11631,1876,618
2020-04-25,404,105,75,88,26,9,149,52,42,540,116,65,,,,412,101,53,US_NY_36085,11719,1902,627
2020-04-26,332,88,60,46,23,7,99,51,33,332,126,78,,,,194,87,52,US_NY_36085,11765,1925,634
2020-04-27,610,117,87,107,20,9,304,72,29,721,122,80,,,,545,114,53,US_NY_36085,11872,1945,643
2020-04-28,715,123,57,129,19,8,324,72,36,893,119,63,,,,668,109,55,US_NY_36085,12001,1964,651
2020-04-29,682,120,72,124,19,14,286,53,33,692,118,74,,,,556,97,40,US_NY_36085,12125,1983,665
2020-04-30,599,96,65,130,19,11,218,42,34,592,112,57,,,,478,70,45,US_NY_36085,12255,2002,676
2020-05-01,496,88,56,77,12,8,245,49,24,620,108,73,,,,441,92,45,US_NY_36085,12332,2014,684
2020-05-02,264,63,46,60,18,12,141,29,23,333,88,58,,,,259,63,49,US_NY_36085,12392,2032,696
2020-05-03,248,62,46,35,15,15,104,43,35,248,79,48,,,,150,57,27,US_NY_36085,12427,2047,711
2020-05-04,463,90,42,90,15,8,214,54,19,432,82,49,,,,347,68,35,US_NY_36085,12517,2062,719
2020-05-05,434,77,49,78,12,12,243,42,18,462,66,43,,,,294,85,27,US_NY_36085,12595,2074,731
2020-05-06,451,76,38,60,7,8,166,36,17,443,66,53,,,,281,71,28,US_NY_36085,12655,2081,739
2020-05-07,401,87,45,60,7,3,119,34,22,356,65,36,,,,294,59,27,US_NY_36085,12715,2088,742
2020-05-08,349,79,42,42,10,5,100,41,13,343,53,45,,,,252,71,21,US_NY_36085,12757,2098,747
2020-05-09,121,57,28,32,7,3,74,29,16,256,42,30,,,,177,47,21,US_NY_36085,12789,2105,750
2020-05-10,191,43,25,14,5,8,94,28,20,85,38,30,,,,75,36,13,US_NY_36085,12803,2110,758
2020-05-11,409,77,32,27,4,3,192,40,13,376,71,24,,,,227,53,27,US_NY_36085,12830,2114,761
2020-05-12,400,57,33,53,8,6,163,30,14,314,53,15,,,,354,52,20,US_NY_36085,12883,2122,767
2020-05-13,364,68,22,48,9,6,155,42,8,304,51,24,,,,454,49,15,US_NY_36085,12931,2131,773
2020-05-14,332,61,14,41,13,6,149,32,16,333,63,21,,,,255,47,9,US_NY_36085,12972,2144,779
2020-05-15,260,60,26,33,7,6,137,43,12,265,64,25,,,,177,54,16,US_NY_36085,13005,2151,785
2020-05-16,164,48,23,25,9,2,56,18,9,135,60,20,,,,110,30,27,US_NY_36085,13030,2160,787
2020-05-17,138,37,18,10,4,2,50,19,11,107,38,24,,,,56,25,19,US_NY_36085,13040,2164,789
2020-05-18,270,59,15,38,4,2,133,31,10,274,49,17,,,,185,35,11,US_NY_36085,13078,2168,791
2020-05-19,331,65,16,42,8,5,168,39,10,288,50,11,,,,177,42,11,US_NY_36085,13120,2176,796
2020-05-20,326,49,20,57,6,7,165,25,12,247,45,22,,,,275,39,15,US_NY_36085,13177,2182,803
2020-05-21,345,66,15,77,10,3,146,26,6,307,38,9,,,,192,32,12,US_NY_36085,13254,2192,806
2020-05-22,387,61,13,32,7,5,156,35,5,226,51,28,,,,259,42,12,US_NY_36085,13286,2199,811
2020-05-23,163,34,20,37,6,2,47,21,7,130,44,14,,,,87,25,17,US_NY_36085,13323,2205,813
2020-05-24,181,35,12,14,4,5,70,28,6,118,28,11,,,,96,26,13,US_NY_36085,13337,2209,818
2020-05-25,174,33,14,17,5,3,71,26,12,106,46,12,,,,97,31,8,US_NY_36085,13354,2214,821
2020-05-26,339,34,10,56,3,1,127,27,7,261,45,9,,,,270,41,10,US_NY_36085,13410,2217,822
2020-05-27,260,53,11,44,3,2,111,28,9,164,53,18,,,,173,25,9,US_NY_36085,13454,2220,824
2020-05-28,227,48,13,26,8,1,96,29,3,172,33,9,,,,110,23,12,US_NY_36085,13480,2228,825
2020-05-29,177,31,16,26,9,2,79,30,5,209,46,14,,,,158,44,6,US_NY_36085,13506,2237,827
2020-05-30,110,29,10,15,3,1,39,12,12,107,24,17,,,,75,25,12,US_NY_36085,13521,2240,828
2020-05-31,81,26,11,11,2,2,24,14,5,69,31,15,,,,30,18,6,US_NY_36085,13532,2242,830
2020-06-01,253,37,10,39,2,3,81,23,3,139,35,14,,,,151,26,3,US_NY_36085,13571,2244,833
2020-06-02,200,31,6,33,6,1,72,25,8,160,37,15,,,,110,26,7,US_NY_36085,13604,2250,834
2020-06-03,144,39,13,42,5,3,78,25,7,147,26,8,,,,100,19,10,US_NY_36085,13646,2255,837
2020-06-04,144,31,10,28,1,2,89,15,7,137,15,10,,,,113,26,3,US_NY_36085,13674,2256,839
2020-06-05,132,19,6,9,1,1,60,10,7,104,17,5,,,,102,16,7,US_NY_36085,13683,2257,840
2020-06-06,59,12,9,7,0,0,31,8,3,98,9,10,,,,51,19,11,US_NY_36085,13690,2257,840
2020-06-07,53,15,5,4,0,1,23,6,1,74,6,10,,,,42,18,7,US_NY_36085,13694,2257,841
2020-06-08,113,20,12,16,2,0,73,7,2,143,15,13,,,,97,16,10,US_NY_36085,13710,2259,841
2020-06-09,131,18,7,19,1,2,67,7,8,127,8,9,,,,79,16,6,US_NY_36085,13729,2260,843
2020-06-10,99,9,11,13,2,2,66,8,2,111,11,7,,,,74,16,8,US_NY_36085,13742,2262,845
2020-06-11,107,13,5,15,0,1,61,4,2,110,9,7,,,,60,12,5,US_NY_36085,13757,2262,846
2020-06-12,122,20,6,18,1,0,62,7,3,126,10,7,,,,75,11,5,US_NY_36085,13775,2263,846
2020-06-13,52,9,4,1,1,1,24,3,2,73,7,1,,,,43,6,4,US_NY_36085,13776,2264,847
2020-06-14,54,11,6,4,0,2,29,4,2,66,14,6,,,,27,12,6,US_NY_36085,13780,2264,849
2020-06-15,98,21,4,17,0,2,61,5,2,115,10,4,,,,65,13,5,US_NY_36085,13797,2264,851
2020-06-16,130,15,6,20,0,0,68,5,3,117,15,7,,,,66,12,4,US_NY_36085,13817,2264,851
2020-06-17,98,13,7,16,0,0,68,5,3,89,12,7,,,,65,12,2,US_NY_36085,13833,2264,851
2020-06-18,98,12,4,23,0,1,54,4,4,108,14,6,,,,52,6,1,US_NY_36085,13856,2264,852
2020-06-19,77,21,3,4,0,2,47,4,3,108,3,3,,,,70,8,3,US_NY_36085,13860,2264,854
2020-06-20,37,10,3,5,0,2,33,5,2,43,5,3,,,,45,6,5,US_NY_36085,13865,2264,856
2020-06-21,36,11,3,7,2,2,14,3,4,41,7,7,,,,18,6,5,US_NY_36085,13872,2266,858
2020-06-22,66,9,4,10,1,2,38,5,4,69,5,3,,,,58,8,1,US_NY_36085,13882,2267,860
2020-06-23,29,1,2,6,1,0,30,2,2,51,5,1,,,,26,10,3,US_NY_36085,13888,2268,860
2020-06-24,27,0,1,1,0,0,11,0,1,23,2,1,,,,28,0,0,US_NY_36085,13889,2268,860
2020-06-25,1,0,0,0,0,0,1,0,0,5,0,0,,,,3,0,0,US_NY_36085,13889,2268,860
